type octile
height 7
width 4
map
....
....
....
@..@
....
....
....